# # . # # 
# . . . # 
. . E G1. 
# . . . . 
# # . P . 
!
^ 
.