# . . . # 
. . . . . 
. . E . @1
. . . . . 
. . . . P 
!
^ 
.