# # # . . 
# E . . O 
# # # . . 
. . . . . 
P . . . . 
!
>
^