# # # . O 
# E . . . 
# # # . . 
. . . . . 
P . . . . 
!
>
^