# # . # # 
# . . . # 
* . P E *
# . . . #
# # . # #
!
<
.