# . T # O . . 
# . . # * # E 
. . . # # # # 
. . . . . . . 
> . G2. . O .
# . . . . . . 
* . . . . P .
!
<
@2