# . T # O . . 
# . . # * # E 
. . . # # # # 
. . . . . . . 
> . G2  . O .
# . . . . . . 
* . . . . P .
!
<9
@2