# . T # O . . 
# . . # * # . 
. . . # # # # 
. . . . . . . 
> . . . . O .
# . . . . . . 
* . . . . P .
!
<9
@2