OOOO.OOOOO.OOOO.OOOOO
P..O.O...O.O....O...O
OOOO.O.*.O.OOOO.O.*.O
O.E..O...O....O.O...O
OOOO.OOOOO.OOOO.OOOOO
!
J
F