. . . . . # E 
. . . . . . . 
. # . # . . . 
@2. . G1# # # 
> . . . @2V # 
@2. . . . . #
P . . . . < # 
!
>
G4
