. . . . . . . 
. . . . . # E 
. # . # . . ^  
@2. . G1# # # 
. . . . G2V # 
O . . . . . .
P . . . . < . 
!
>
G2
