* . . O . . E 
. . . . . . . 
. O . O . . # 
# . . . . . . 
. O . . . O . 
. . . . . . .
P . . # . . * 
!
J
F
