00000B0000
00000B0000
00000BBB00
0000000000
0000000000
00000BBB00
00000BBB00
0000000000