. . . . . #1. . . . . .
. . . . . # . . . . . .
. . . . . # # # . . . .
. . P . . . . . ^ . . .
. . . . . J L T F . . .
. @ . . . # # # . . . .
. . . . . # # # . . . .
. . . . . . . . . . . .
!
^
@