. . . . . #1. . . . . .
. . . . . # . . . . . .
. . . . . # # # . . . .
. . . . . . . . . . . .
. . . . . . . . . . . .
. . . . . # # # . . . .
. . . . . # # # . . . .
. . . . . . . . . . . .
!
>
.