O < . . . 
. . # # . 
. . # # . 
. . . @1. 
P . # # E 
!
>
G2